+---------+-+-------+-----+
|R  D     |H|   |       D |
+-  P | | | | | +-- | | P |
|   D | | | |R|     D | D |
| --+ +-+ | |-+ +-- P +-- |
|     D | | |   D   D     |
|DPD+ P | | | | P --+---- |
|     D | D   | D         |
| ----+ | P . | | --+--DPD|
|         D   D | D |K    |
| --+ | ----- P | P +-- | |
|   | |       D | D |   | |
+-- +-+DPD+-- --+-- |DPD| |
|EL |R    |               |
+-------------------------+