+-------------------+
|H|          SW   D |
| | | +--DPD+---+ P |
| |K|T|     |S  | D |
| +-+-+ . . +-- | | |
|     D           | |
| --- P . . --+ +-+ |
|     DS    D | |   |
|DPD| --+ |DP | +--L|
| D |  S| |G  | |  E|
+-------------------+