+-------------------+
|H|          SW   D |
| | | +--DDD+---+ D |
| |K|T|     |S  | D |
| +-+-+ . . +-- | | |
|     D           | |
| --- D . . --+ +-+ |
|     DS    D | |   |
|DDD| --+ |DD | +--L|
| D |  S| |G  | |  E|
+-------------------+