+---------+-+-------+-----+
|R  D     |H|   |NS     D |
+-  P | | | | | +-- | | P |
|   D |S| | |R|     D | D |
| --+ +-+ | |-+ +-- P +-- |
|    ND | | |   DS  D     |
|DPD+ P | | | | P --+---- |
|     D | D   | D         |
| ----+ | P . | | --+--DPD|
|         D   D | D |K    |
| --+ | ----- P | P +-- | |
|   |N|       D | D |S  | |
+-- +-+DPD+-- --+-- |DPD| |
|EL |R    |N              |
+-------------------------+